####################
#    A             #
#             o    #
#                  #
#       o          #
#                  #
#                  #
#  o               #
#                  #
####################

