####################
#             o    #
#                  #
#                  #
#                  #
# o A              #
#                  #
#        o         #
#                  #
####################

